1111111111111111
10000000c0000001
1000000000000001
100p000000000001
1000000c00000001
1000000000000001
1000c0000000c0e1
1111111111111111
